W,W,W,W,W,W,W,W,W
W,P,,T,,,W,G,W
W,,,,W,,,,W
W,,B,,W,,,,W
W,,B,,W,,,Oa,W
W,,B,,W,,,,W
W,,,,W,,,,W
W,G,,Ia,W,,,,W
W,W,W,W,W,W,W,W,W
