,,W,W,W,W,W,
W,W,W,,,,W,
W,G,P,B,,,W,
W,W,W,,B,G,W,
W,G,W,W,B,,W,
W,,W,,G,,W,W
W,B,,GB,B,B,G,W
W,,,,G,,,W
W,W,W,W,W,W,W,W
