,,W,W,W,W,W,
W,W,W,,O1,,W,
W,G,P,B,,,W,
W,W,W,I1,B,G,W,
W,G,W,W,B,,W,
W,,W,,G,,W,W
W,B,,GB,B,B,G,W
W,,,,G,,,W
W,W,W,W,W,W,W,W
