W,W,W,W,W,,W,W,W
W,P,,,W,,W,G,W
W,,,,W,,W,,W
W,,B,,W,,W,,W
W,,,I1,W,,W,O1,W
W,,,,W,,W,,W
W,T,,I2,W,,W,O2,W
W,,,,W,,W,,W
W,W,W,W,W,,W,W,W
